....................................................................
....................................................................
####################################################################
....................................................................
.....@..............................................................
####################################################################
....................................................................
....................................................................